24 30
0 0 0 0 0 0 0 0 0 0 0 0 0 0 0 0 0 0 0 0 0 0 0 0
0 0 0 0 0 8 8 8 0 0 0 0 0 0 0 0 0 18 19 0 0 0 15 0
0 8 8 8 0 8 8 8 0 0 0 0 0 0 0 0 18 17 17 19 0 0 0 0
0 8 8 8 0 0 7 0 0 0 0 0 0 0 0 0 16 16 16 16 0 0 0 0
0 0 7 0 0 0 12 0 0 0 9 9 9 0 0 14 16 22 16 16 1 0 0 0
0 0 4 0 0 0 0 0 0 0 9 9 9 0 0 14 14 14 14 14 14 0 0 0
0 0 12 0 0 0 0 0 0 0 0 0 0 0 0 0 0 0 0 0 0 0 0 0
0 0 0 0 0 0 0 0 0 0 0 0 0 0 0 0 0 0 0 0 8 8 8 0
0 0 0 0 0 0 0 0 0 0 0 0 0 0 0 0 0 0 0 0 8 8 8 0
0 0 0 0 26 26 26 40 39 39 39 39 39 39 39 39 39 39 39 40 0 7 0 0
0 0 0 0 26 24 26 37 0 0 0 0 0 15 0 0 0 0 0 36 0 12 0 0
0 0 0 0 26 24 26 37 0 8 8 8 0 0 0 8 8 8 0 36 0 0 0 0
0 0 0 0 26 24 26 37 0 8 8 8 0 0 8 8 8 8 8 36 0 0 0 0
0 0 0 0 26 24 26 37 0 11 7 11 0 0 0 8 8 8 0 36 0 0 10 0
0 0 0 0 26 24 26 37 0 0 7 0 0 13 0 0 7 11 0 36 0 0 0 0
0 0 0 0 26 24 26 37 0 0 12 0 0 0 0 11 7 0 0 36 0 0 0 0
0 0 0 0 26 24 26 37 0 0 0 0 0 0 0 0 12 0 0 36 0 0 0 0
0 0 0 0 26 24 26 37 0 0 0 0 0 0 0 0 0 0 0 36 0 0 0 0
26 26 26 26 26 24 26 37 0 0 10 0 0 0 0 0 0 0 13 36 0 0 0 0
35 25 25 25 25 27 26 40 38 38 38 38 38 38 38 38 38 38 38 40 0 0 0 0
26 26 26 26 26 26 26 0 0 0 0 0 0 0 0 0 0 0 0 0 0 0 0 0
0 0 0 0 0 0 0 0 8 8 8 0 0 0 0 0 0 0 0 0 0 0 0 0
0 0 0 0 0 0 0 0 8 8 8 0 0 0 0 0 0 0 0 0 0 0 0 0
0 0 18 17 17 17 19 0 0 7 0 0 8 8 8 0 0 0 0 0 0 0 3 0
0 0 16 16 16 16 16 0 0 12 0 0 8 8 8 0 0 10 10 10 0 0 0 0
0 0 16 20 16 21 16 0 0 0 0 0 0 7 0 0 0 10 10 10 0 0 0 0
0 14 16 16 22 16 16 1 0 0 0 0 0 12 0 0 0 0 0 0 0 0 0 0
0 14 14 14 14 14 14 14 0 0 0 0 0 0 0 0 0 0 0 0 0 0 0 0
2 2 2 2 2 2 2 2 2 2 2 2 2 2 2 2 2 2 2 2 2 2 2 2
23 23 23 23 23 23 23 23 23 23 23 23 23 23 23 23 23 23 23 23 23 23 23 23