18 13
0 0 0 0 0 0 0 31 38 35 38 32 0 0 0 0 0 0
0 0 0 0 0 0 0 36 26 24 26 37 0 0 0 0 0 0
0 0 0 0 0 0 0 36 26 24 26 37 0 0 0 0 0 0
0 0 0 0 0 0 0 36 26 24 26 37 0 0 0 0 0 0
0 0 0 0 0 0 0 36 26 24 26 37 0 0 0 0 0 0
0 0 0 0 0 0 0 36 26 24 26 37 0 0 0 0 0 0
0 0 0 0 0 0 0 36 26 24 26 40 38 38 38 38 32 31
0 8 8 8 0 0 0 36 26 24 26 26 26 26 26 26 26 26
0 8 8 8 0 0 0 36 26 28 25 25 25 25 25 25 25 25
0 0 7 0 0 0 0 36 26 26 26 26 26 26 26 26 26 26
0 0 12 0 0 0 0 34 39 39 39 39 39 39 39 39 33 31
14 14 14 14 14 14 14 14 14 14 14 14 14 14 14 14 14 14
23 23 23 23 23 23 23 23 23 23 23 23 23 23 23 23 23 23